xxxxxxxxxxxxxxxx
x..............x
x...........xx.x
x.........x.xx.x
x.........x....x
x.........xx...x
x.......x....x.x
x.....x.xx..xx.x
x.....x..x...x.x
x.....x........x
x.....x........x
x..............x
x..............x
xxxxxxxxxxxxxxxx
